2 2 2 2 2 2 2 2
2 2 3 3 3 3 0 3
0 2 2 3 0 0 0 0
1 1 2 3 0 0 3 3
1 1 2 3 3 0 5 0
1 1 2 3 0 6 6 1
1 1 2 3 3 7 5 1
1 1 1 1 1 1 1 1